B..................
...................
...................
.......P...........
...................
...................
...................
...................
...................
1111111111111111111


